Movement

W - Run Forward
S - Run Backward
D - Run Right
A - Run Left
Left Control (hold + movement) - Walk

Camera

I - Move Forward (up)
K - Move Backward (down)
L - Move Right
J - Move Left
O - Lock Target on-off / Reset camera

Switch Equipment

V - Switch Right weapon
C - Switch Left weapon
F - Switch Item
R - Switch Magic

Actions

H - Right Weapon Action (attack) / Range attack, uses left slot ammo (attack)
U - Right Weapon Action (heavy attack) / Range attack, uses right slot ammo (attack)
Left Shift - Left Weapon Action (block)
Tab - Left Weapon Action (parry/bash)
E - Use Item
Space - Dash (hold + movement) / Roll (tap + movement) / Backstep (tap)
Q - Action / Gesture (hold)
Left Alt - Toggle one-hand / two-hand grip

Menu Display

END - Open Start Menu
G - Open Gesture Menu

Menu Control

Up Arrow - Select (up)
Down Arrow - Select (down)
Left Arrow - Select (left)
Right Arrow - Select (right)
Enter - Confirm
Backspace - Cancel
Insert - Menu Function 1: Switch Status, etc.
Delete - Menu Function 2: Toggle Display, Remove Equip, etc.
Page Up - Switch Menu (right)
Page Down - Switch Menu (left)